22
13
0000000000000000000000
0433303333333333033340
0300303000000003030030
0303333333333333333030
0303003000110003003030
0303333011151103333030
0333003000000003003330
0333333333633333333030
0303003000000003003030
0303333333333333333030
0300303000000003030030
0433303333333333033340
0000000000000000000000






